000000000000000000000000000000000000000000000000000000000000
011111111111111111111111111111111111111111111111111111111110
010000100000000010000000000000001000000001555100000010000010
010000102222222010000000000000001000000001525100000010000010
011111102000000011111111111111111111111111525111111111111110
000000102011111113333333144444441006660001525133333333310000
000000102010000013222223142222241022222201525132222222310000
111111102010000013233323142444241022222201525132222222311111
111111102011102013232323142424241022222201525132333333311111
111111102000002013233323142444241000000001525132311111111111
000000102222222013222223142222241111111111525132333333310000
000000100000000013333333144444441000000001555133333333310000
011111111111111111111111111111111022222201111111111111111110
010000010000000001001000000000001000000001000000010001000010
010222010222222201001022222222201111001111022222010201022010
010000010000000001001000000000001001001001000000010001000010
011111111111111111001111111111111001111001111111111111111110
000000000000000000000000000000000000000000000000000000000000
777777777777777777777777777777777777777777777777777777777777